10 20
|------------------|
|.........|........|
|....|....|........|
|....|.............|
|..................|
|..--.......|......|
|......|...........|
|......|.....---...|
|..................|
|------------------|
