11 27
|-------------------------|
|.........................|
|.|||||||||||.|||||||||||.|
|.|.....................|.|
|........||||.||||........|
|........|.......|........|
|..||......|||||......||..|
|........|.......|........|
||||.....||||.||||.....||||
|.........................|
|-------------------------|