10 20
|------------------|
|.........|........|
|..@.|....|........|
|....|.............|
|..................|
|..--....#..|......|
|......|...........|
|......|.....---...|
|..................|
|------------------|
