8 15
|-------------|
|.............|
|..-...@...|..|
|.............|
|...|.........|
|..-.#...-....|
|..-.....-....|
|-------------|


